######################
#....................#
#....................#
#....................#
#....................#
#....................#
#....................#
#####.....#####......#
#####.....#####......#
#....................#
#....................#
#....................#
#....................#
#....................#
#....................#
######################