###############
#.............#
#.............#
#.............#
#.............#
#.............#
#.............#
#####.....#####
#####.....#####
#.............#
#.............#
#.............#
#.............#
#.............#
#.............#
###############