##########################################
#........................................#
#........................................#
#........................................#
#..........................#####.....#####
#..........................#####.....#####
#........................................#
#####.....#####..........................#
#####.....#####..........................#
#........................................#
#..........................#####.....#####
#..........................#####.....#####
#........................................#
#........................................#
#........................................#
##########################################